Achiropita	Acheropita
Ada	Adina	Adamaria	Adalisa
Addis	Adis	Abeba	Aba
Addolorata	Dolorata
Adelaide	Adelaida	Adelasia	Ada	Adele	Alida	Alice
Adele	Adela	Adelina
Adelina	Alina
Adelinda	Adalinda	Adelonda	Delinda	Dalinda	Linda
Adelisa	Adelisia	Delisa
Adriana	Adria
Afra	Africa	Africana
Afrodite	Afroditi
Agape	Agapio	Agabio
Agar	Agarita
Agata	Agatina	Agatella
Agnese	Ines	Agnesina
Agrippina	Pina
Aida	Aiduccia	Ida	Aide
Alba	Albarosa	Rosalba	Albachiara
Alberta	Albertina	Berta	Tina
Alessia	Ale
Alice	Alicia	Ali
Alida	Alide	Alidea
Allegra	Allegrina	Allegretta
Alma	Almina
Amalasunta	Amalasuenta
Amalia	Amelia	Malia	Malina
Amanda	Manda	Amandina
Amarilli	Amarillide
Amelia	Amalia	Lelia	Meli
Anastasia	Anastagia
Ancilla	Ancella
Andreina	Andrea	Andreana	Andreuccia	Andreuola	Andreola	Andrietta	Andrettina	Dozza
Angela	Angiola	Angelina	Angiolina	Angeletta	Angiolina	Angioletta	Lina	Lalla	Pierangela	Mariangela	Michelangela	Rosangela
Annunziata	Annunciata	Annunziatina	Annunzia	Annuncia	Nunziata	Nunzia	Nuncia	Nunziatina	Nunziatella	Nunziella	Nunzietta	Tina
Antea	Tea
Antonia	Antonella	Antonietta	Antonina	Antoniana	Antonica	Tonia	Tonina	Nella	Nina
Antonietta	Antonetta	Mariantonietta
Argentina	Argenta	Argenzia
Argia	Argea
Arianna	Ariana	Ari
Artemisia	Artenisia
Assunta	Assuntina	Mariassunta
Atena	Atene
Augusta	Augustina	Gusta	Tina
Aurea	Oria
Aurelia	Lelia
Aurora	Aura
Ave	Ava
Azzurra	Azzurrina
Barbara	Barbera	Barbarella	Barbarina	Barberina
Basilissa	Basilla
Batilde	Batilda	Tilde
Battistina	Battista	Titti	Tittina
Beatrice	Bice
Bella	Bellina
Benedetta	Benedettina	Betta	Bettina
Benilde	Benilda	Nilde
Berenice	Nice	Bice
Berta	Bertina	Bertilla
Betta	Bettina
Bianca	Bianchina	Bibi
Bibiana	Bibbiana
Biblide	Bibli
Bililde	Bilichilde	Bililda
Bona	Buona	Bonina	Bonuccia	Bonella
Bonagiunta	Buonagiunta	Bonazunta
Brigida	Brigitta
Brunilde	Brunilda	Brunechilde	Brunelda	Ilda	Nilde
Buonadonna	Bonadonna
Camilla	Cammilla	Camila	Milla	Milly	Cami
Carla	Carola	Carlotta	Carlina	Carolina
Carmela	Carmina	Carminia	Carmen	Carmelina
Casilde	Casilda
Catena	Catina
Caterina	Catterina	Catarina	Catrina	Catalina	Cattalina
Celestina	Celeste
Celia	Celina
Cesira	Cesiria
Chiara	Clara	Clarissa	Chiarina	Chiaretta	Claretta	Chiarastella	Chiaristella	Mariachiara
Clarissa	Clarice
Claudia	Clodia	Claudina	Claudiona
Clementina	Mentina	Tina
Cleopatra	Clea	Cleo
Clio	Clia
Clori	Clora	Cloride	Clory	Clorina
Clotilde	Ilde	Tilde	Clotilda
Concetta	Concepita	Concezione	Concettina	Cettina	Tina	Concita
Consolata	Consolatina	Lina	Tina
Corallo	Coralla	Corallina	Coralina
Cordelia	Delia
Corinna	Corina
Cornelia	Nelia	Lelia
Cosima	Cosmana	Cosimina	Mimina	Mimma
Costanza	Constanza	Costante	Costantina	Tancia	Zina
Crimilde	Grimilde	Ilda
Criseide	Criseida	Criside	Cressida
Cristiana	Cristina
Cristina	Cristiana
Crocifissa	Crocefissa	Croce	Crocetta
Cunegonda	Conegonda
Dalia	Daliana
Dalila	Dalida
Damaride	Damari	Damaris	Damiris
Daniela	Danila	Daniella	Nila	Dania	Niela	Lela	Lella	Dani
Daria	Dariella	Darina
Debora	Deborah
Desdemona	Disdemona
Desolina	Dosolina	Dusolina	Dasolina	Disolina	Drusolina	Tesolina	Tosolina	Tusolina	Dusola	Dusa
Diamantina	Diamante	Adamante
Diana	Daiana	Dianella	Dianina	Anella	Nella	Nina
Diomira	Deomira	Dionira	Teomira
Dionisia	Dionigia
Dirce	Dircea
Diva	Divia	Divina	Divinia	Divinangela
Domenica	Domenichina	Nica	Mimma	Mena	Mimi	Mariadomenica
Donata	Donatella	Donatilla	Donatina
Dora	Dorina	Dorella	Doretta	Dorita	Doralba
Doralice	Dora
Dorotea	Tea	Dora
Edera	Ederina	Edra
Editta	Ditta
Edvige	Edwige	Eduvige	Edda
Eglantina	Eglentina
Egle	Egla	Ecle	Eglina	Eglice
Elba	Ilva	Ilvia	Elbina	Milvia
Elda	Eldina
Elena	Elenia	Ele	Lena	Marilena
Eleonora	Elianora	Ele	Leonora	Nora	Lora
Elfrida	Frida
Eliana	Liana
Elide	Elida	Elidia	Ellide	Ellida
Elisa	Lisa	Isa	Eli
Eloisa	Eloisia
Elsa	Elsina
Elvira	Elviria	Elvi	Elvirina
Emanuela	Manuela	Lela
Emerenziana	Merenziana	Emi
Emilia	Milia	Emi
Enrica	Errica	Enrichetta	Rica
Enrichetta	Errichetta
Erica	Erika
Eride	Eris
Ermelinda	Armelinda	Melinda	Linda
Ermellina	Ermelina	Armellina	Armella
Ermengarda	Irma
Ersilia	Arsilia
Esperia	Espera	Esperina
Ester	Esther	Esterre	Esterina
Eufemia	Femia
Eufrasia	Eufrasina
Eufrosina	Eufrosine	Eufrosia
Eurosia	Orosia
Evelina	Avelina	Avellina	Evelia	Avelia	Evellia	Lina	Velia
Fabiola	Fabilla
Fatima	Fatina	Fathima
Febronia	Febbronia
Fede	Fides
Federica	Fede	Chica	Chicca
Fedora	Dora
Felicia	Felicetta	Licia
Fenisia	Finisia	Fenizia	Finizia	Enis
Fiamma	Fiammetta
Fiorenza	Fiorenzia	Florenza	Fiorenzina
Flora	Floria	Florisa	Floretta	Florina	Florinda
Fonte	Fontana	Fontina
Fortuna	Fortunella
Franca	Franchina
Francesca	Franceschina	Franca	Cesca	Cecca	Checca	Francy	Chicca	Fra
Gabriella	Gabriela	Gabbriella	Gabrielina	Gabria	Lella
Geltrude	Gertrude	Gertruda
Gemma	Gemmina
Genoveffa	Genoeffa
Giacoma	Giacomina	Giacometta	Giacomella	Mina
Gina	Ginetta
Gioia	Zoia	Gioietta	Gioella	Gioina	Gioiosa
Giorgia	Giorgina	Giorgiana	Giorgetta	Gina
Giovanna	Gioanna	Ioana	Giovannina	Giovannella	Giovannetta	Giovannica	Gianna	Giannina	Nanna	Vanna	Zanna	Gia	Nina
Gisella	Gisela	Giselda
Giulia	Giulietta
Giuliana	Liana
Giuseppa	Gioseffa	Giuseppina	Peppa	Beppa	Giusi	Pina
Giuseppina	Geppina	Peppina	Beppina	Pina	Nuccia	Giusi	Pinuccia
Gloria	Glori
Grazia	Graziella	Mariagrazia
Greca	Grecia
Griselda	Elda
Guendalina	Guendolina	Guenda	Lina
Guglielma	Guglielmina	Vilelmina	Villelmina	Villermina	Mina	Gelma	Gelmina	Gilma	Mema	Memma	Wilma	Zelma	Zelmina
Gunilde	Gunilda
Idalia	Idalina
Idelma	Idelmina	Delma
Ifigenia	Efigenia
Ilaria	Ilarina	Ilarietta	Ilariuccia	Laria	Rina	Ila
Ilde	Elda	Marilda
Ildegarda	Ilda
Ileana	Illeana
Ilenia	Ylenia	Hilenia	Ilena	Jlenia
Imelda	Imelde	Inelda	Inelde
Immacolata	Imma	Ima
Incoronata	Coronata
Iolanda	Jolanda	Yolanda
Iole	Jole	Yole	Ioletta
Ione	Jone
Irene	Irena	Erina
Iris	Iride	Irida	Ires	Ireos
Irma	Irmina
Isa	Isabella	Isidora	Isotta	Luisa	Elisa
Isabella	Bella	Ella	Isa
Iside	Isida	Isidea	Isis
Isola	Isora	Isolina	Isoletta	Isoliera
Isotta	Isolda	Iselda	Isilde
Iva	Ivetta
Jessica	Gessica
Katia	Catia
Lalla	Angela	Angelica	Coralla	Italia	Laura
Lara	Larissa
Laura	Lora	Laurana	Lauretta	Laurina	Lauriana	Laurisa	Laurita	Laurinda	Laurice	Lauria	Lalla
Lavinia	Lavina
Leda	Ledina
Leila	Laila
Lena	Lenuccia	Marilena	Annalena
Leocadia	Leucadia
Leonilda	Leonilde
Lia	Lya	Lietta
Liana	Lianella
Licia	Lycia	Lice
Lidia	Lydia	Ljdia	Lidya	Lida	Lyda	Lide
Liduina	Liduvina
Liliana	Lilliana	Lilia	Liana
Lina	Linuccia	Linetta
Lisa	Annalisa	Lisanna
Livia	Liviana	Livietta
Lodoletta	Iodola
Lora	Lorella	Loretta	Lorina	Lori	Lorisa
Loredana	Lora	Dana
Lorelei	Loreley	Lorely
Lorenza	Laurenza	Laurenzia	Lorenzina	Laurentina	Lorentina	Lora	Enza	Renza	Zina
Luce	Lucetta	Lucina
Lucia	Luce	Lucina	Lucilla	Lia	Cia
Lucrezia	Lugrezia	Zina	Lucri
Luisa	Luigia	Loisia	Luisella	Luisetta	Luisina	Luisita	Isa	Lulu
Luna	Lunella	Lunetta
Lutgarda	Liutgarda
Maddalena	Magdalena	Magda	Magdala	Madda	Maida	Lena
Maia	Maja	Maya
Malvina	Malva
Mara	Maretta	Marella
Marcella	Marcellina	Cellina	Celina	Lella
Marcellina	Cellina	Celina
Marfisa	Marfisia
Margherita	Margarita	Margareta
Maria	Marica	Maia	Mia
Marialuisa	Marisa	Marilu
Mariarosa	Marirosa
Mariangela	Mariangiola
Marianna	Mariannina
Marica	Marika
Marilda	Marilde
Marina	Marinella	Marinetta	Rina
Marisa	Marisella	Marisetta	Marisina	Marissa
Maristella	Mariastella
Martina	Martinella	Martinetta	Marti	Tina	Ina
Marzia	Marzina	Marsina
Massima	Massimina	Massimilla
Matilde	Matilda	Matelda	Metilde	Mafalda	Macalda	Tilde
Messalina	Alina	Lina
Michela	Micaela	Michelina	Michelangela	Lina
Milena	Mila	Lena
Mimosa	Mimi
Mina	Guglielmina	Giacomina	Anselmina
Minerva	Minervina
Miranda	Mirandolina	Mirandina	Miranduccia	Mira
Miriam	Miriana	Miria	Myria	Myriam	Miryam	Mirjam	Mjriam	Mirian
Mita	Mite
Nadia	Nadja	Nadya	Nada	Nadda	Nadea	Nadeia	Nadina	Nadine	Nadiana
Natalia	Natala	Natalina	Natalizia	Natascia	Nata
Nausicaa	Nausica
Nicoletta	Nicolaia	Nicolina	Niccoletta	Niccolina	Nicole	Nica	Nicla	Coletta	Lina
Nike	Naike
Nilde	Nilda
Nilva	Nilvia	Nilvana
Nirvana	Mirvana
Nives	Nieves	Nieve	Nive	Nivea	Nivia	Niva	Neves	Nevi	Neve	Neva
Nora	Norina
Novella	Novilia	Novellina	Novissima	Lella
Nuccia	Nuzza	Nucci
Odetta	Odette
Odilia	Odilla	Odile	Ottilia	Otilia	Udilia	Udilla	Utilia
Ofelia	Felia
Olimpia	Olimpiade
Oliva	Uliva	Olivana	Olivetta
Ombretta	Ombra	Umbra	Umbria
Ondina	Onda	Undina
Oria	Oriana	Oride	Oriade	Orietta	Oriella	Orina
Oriana	Orianna
Ornella	Ornelia
Orsola	Ursula	Ursola	Orsolina
Ortensia	Ortenzia
Palma	Palmina
Paola	Paolina	Paoletta
Paolina	Lina
Parasceva	Parasceve
Pasqua	Pasquina	Pasquetta	Pasquita
Perla	Perlina	Perlita
Petronilla	Pietronilla	Petronella	Nilla
Petunia	Petuniana	Petunina	Petuniuccia	Nina	Tunia	Nuccia
Pietra	Piera	Pietrina	Pierina	Peronella
Polimnia	Polinnia
Porzia	Porsia
Prassede	Prasseda
Preziosa	Preziosilla
Priscilla	Scilla
Provvidenza	Providenza	Enza
Rachele	Rachelina
Radegonda	Redegonda	Gonda
Raffaella	Raffaela	Rafaela	Raffaelina	Raffaellina	Raffelina	Lella	Raffa
Regina	Reggina	Reina	Reginella	Reginetta	Gina
Riccarda	Ricciarda	Rizzarda	Ricarda
Richilda	Richilde
Rita	Annarita
Roberta	Robertina	Berta
Roma	Rometta	Romina
Romilda	Romilde	Milda	Milde
Rosa	Rosi	Rosy	Rosina	Rosetta	Rosella	Rossella	Rosellina	Rosuccia	Rosanna	Annarosa	Rosalba	Mariarosa	Rosangela	Rosaura	Rosalinda
Rosalia	Rosolia	Lia	Rosolina
Rosalinda	Rosalina	Linda
Rosaura	Rosa	Aura
Rosmunda	Rosamunda
Rossa	Rossella	Rossina	Rossabella
Rossana	Rossane	Rossanda
Rossella	Rossellina
Rubina	Rubi
Sabina	Savina
Samantha	Samanta
Sandra	Sandrina
Santippe	Santippa
Sara	Sarina	Saretta
Sefora	Zippora
Selene	Selena	Selenia
Semiramide	Semira
Serena	Serenella	Serenilla
Sibilla	Sibilia	Sibillina
Silvana	Silvanina	Silvanetta	Silvanella	Silvanuccia	Nuccia	Nina
Silvia	Silva	Sylvia	Sylva	Silvina	Selvina	Silvietta	Silvi
Simona	Simeona	Simonetta	Simonina	Simoncina	Simonella	Simo	Mona
Sinforosa	Sinfarosa	Sinfrosa
Smeralda	Esmeralda
Sofia	Sonia
Sole	Mariasole	Solemaria
Sonia	Sonya	Sonja
Speranza	Speranzia	Speme	Speranzina
Stamura	Stamira
Stefania	Stefana	Stefanina	Stefanella	Stefi	Ste	Stenia	Stena	Stefa	Fania
Stella	Estella	Estelle	Stellina	Maristella	Mariastella
Sulamita	Sulammita	Sulamitide
Susanna	Susi	Susy
Sveva	Sueva
Tamara	Tamar
Tatiana	Tatjana	Taziana
Teodolinda	Tea
Teodora	Fedora	Tea	Dora
Teresa	Teresia	Teresina	Teresita	Teresiana	Sita	Zina
Tilde	Tilda
Tina	Tinuccia	Tinella	Titina
Trifena	Trifene	Trifenia
Trofimena	Trofima	Trifina
Umbelina	Ombelina
Valchiria	Valkiria	Walchiria	Walkiria
Valentina	Vale	Tina
Valeria	Valiera	Valerina	Vale
Valpurga	Valburga	Walburga	Walpurga
Velia	Velina	Veliana
Velleda	Veleda	Velide	Welleda
Venera	Venerina	Nerina
Veneranda	Venera	Vene	Randa	Wanda
Venere	Venerina
Verbena	Verbenia
Verdiana	Veridiana	Viridiana
Vincenza	Vicenza	Vincenzina	Vincenzeretta	Enza	Cencia	Zina
Viola	Violetta
Violante	Violanta	Violanda
Virginia	Verginia	Virna
Vittoria	Vittorina
Viviana	Vivianna
Wanda	Vanda	Wandina	Vandina
Wilma	Vilma
Xenia	Senia
Yvonne	Ivonne	Ivon
Zelmira	Gelmira
Zita	Cita
Abaco	Abacuc	Abacucco	Bacucco
Abbondanzio	Abbondazio
Abbondio	Abondio	Abundio	Bondo
Abdenago	Abdenego
Abdiele	Abdele
Abdieso	Ebedieso
Abdon	Abdone	Abdo
Abelardo	Aberardo	Averardo	Avelardo	Averaldo	Abaelardo	Abailardo	Velardo
Abele	Abelino
Abibo	Abibone
Abramo	Abraham
Abudemio	Abudemo
Acacio	Acazio
Accursio	Accurso	Accorsio	Accorso	Corso
Acepsima	Acessima
Achille	Achilleo	Achillino
Adalardo	Adelardo
Adalbero	Adalpero	Adalberone	Albero	Alberone
Adalberto	Adelberto	Berto
Adalgiso	Adalciso	Adalgisio	Adelciso	Adelchi	Dalciso	Alghisio	Arciso	Dalcisio	Delciso	Algiso	Algisio	Alciso	Arcisio
Adamo	Adamino	Adamuzzo	Adamello	Damino
Ade	Adino
Adelchi	Adelco	Adelchio
Adelfo	Adelfio	Adelfino	Delfo	Delfio
Adelmiro	Adelmaro	Delmiro
Adelmo	Adelmio	Adelmino	Delmo	Delmino
Ademaro	Ademiro	Adimaro	Amerio
Adeodato	Deodato	Diodato	Teodato	Dato	Adeo	Adio
Aderito	Ade
Adiuto	Aiuto
Adolfo	Adinolfo	Adolfino	Dolfo	DOlfino
Adone	Adon
Adorato	Adorando	Dorando
Adorno	Adornino	Adornetto
Agamennone	Menone
Agapito	Agapeto	Agabuto	Bito
Agenore	Age
Aggeo	Ageo
Agilulfo	Agilolfo	Agile
Agnello	Aniello	Anellino
Agostino	Ago	Tino	Dino
Aiace	Ajace
Aimone	Aimo
Aladino	Dino
Alamanno	Alemanno	Almanno	Alamanetto	Amanno	Manno	Manetto
Albano	Albanino	Alpa	Alpinolo
Alberico	Alberigo	Albizzo	Bico
Alberto	Alperto	Ulberto	Ulperto	Albertino	Albertinello	Berto	Albi
Albino	Bino
Albizzo	Albizo
Alboino	Albuino
Alcide	Alcido	Alcidio	Arcide	Arcido	Arcidio
Aldemaro	Aldemario	Aldemiro
Alderico	Alderigo	Alderigi	Aldrico	Olderigi	Olderigio
Aldo	Aldino	Alduccio	Dino	Duccio
Aldobrando	Aldebrando	Aldeprando	Aldibrando	Aldiprando	Aldoprando	Altobrando	Aldrovando	Aliprando	Aldobrandino	Aldrovandino	Brando	Bandino	Aldo
Alduino	Aldoino	Aldovino
Aleardo	Alealdo	Leardo	Leardino	Lealdo
Alessio	Alesso	Alessi	Alex	Ale	Alessino
Alfiero	Alferio	Alfiere	Alfero	Alfieri	Alfierino	Alferino	Olferino
Alfonso	Alfonzo	Alonzo	Alonso	Alfonsino	Fonso
Alfredo	Alfredino	Fredo
Alighiero	Alighieri	Aldighiero	Aldiviero	Adalgerio	Adalgero	Adalgaro	Aldegario	Alghero
Aligi	Aligio
Aliprando	Alibrando	Aliprandino	Alibrandino	Prando	Prandino	Brando	Brandino	Liprando	Librando
Altero	Altiero	Alterio	Altieri
Alvaro	Alvario	Alvero	Alvarino
Alvise	Alvisio	Elvisio
Amalrico	Amalarico
Amanzio	Amante	Amantino
Amaranto	Amarando
Amatore	Amadore	Amadoro
Ambrogio	Ambrosio	Ambrogino	Ambrosino	Ambrogione	Ambrosone	Ambrogiotto	Giotto	Gino	Bogio	Boso	Bosone
Amedeo	Amadeo	Amadio	Amaddio	Amodio	Amideo	Amodeo	Amadigi
Amerigo	Emerico	Almerigo	Almerico	Aimerico	Americo	Merigo	Merico
Aminta	Aminto	Aminda	Amintore
Ampelio	Ampellio	Ampilio	Amperio	Ampeglio
Anacario	Aunacario	Ario
Anacleto	Cleto	Clito
Anania	Anna
Andreino	Andrea	Andreolo	Andreuccio	Andrietto	Andreano	Drea	Dea
Angelo	Angiolo	Agnolo	Angelino	Angiolotto	Angiolino	Angelillo	Angioletto	Angeletto	Lotto	Giotto	Totto	Lino	Michelangelo	Pierangelo
Angilberto	Angelberto	Engelberto	Engilberto	Berto
Ansberto	Ansperto	Berto
Anscario	Ansgario	Ario
Anselmo	Anselmino	Selmo	Selmino
Ansovino	Ansuino
Antero	Anterio	Anterino
Antimo	Antimino
Antinoo	Antino
Antipatro	Antipa
Antonello	Nello	Tonello	Lillo
Antonino	Tonino	Nino
Antonio	Antuono	Antonello	Antonietto	Antoniotto	Antonioccio	Antonino	Tonio	Toni	Tony	Tonino	Toniolo	Nello	Nino	Totino	Nonio	Noccio	Antonmaria	Marcantonio	Pierantonio
Apollodoro	Apollo
Arbogaste	Arbogasto
Arcadio	Arcade	Arcadione
Arcangelo	Arcangiolo
Arcibaldo	Archibaldo	Arcimbaldo	Archimbaldo	Baldo
Arduino	Ardovino	Ardoino	Ardolino
Arezio	Aresio
Ariano	Arriano
Ariele	Ariel	Ariello
Ario	Arino	Arietto	Ariotto	Arione
Armando	Armandino
Arminio	Armino
Arnaldo	Arnoldo	Arnoaldo	Ernaldo	Naldo
Arnolfo	Arnulfo
Aroldo	Araldo	Arioldo	Arioaldo	Ariovaldo	Cariovaldo
Arrigo	Enrico	Arrighetto	Arriguccio	Arriguzzo	Arrigone	Arrighino	Rigo	Righetto	Ghetto	Riguccio	Guccio	Rigguzo	Guzzo	Rigone	Gone	Ghino	Rigoletto
Arsace	Arsacio
Arsenio	Arseno	Arzenio
Artemio	Artemo	Altemio	Artemino
Arturo	Arturino	Rino	Artu
Arunte	Arrunte	Aronte	Aronzio
Assalonne	Assalone
Asterio	Asterione
Astolfo	Astulfo	Aistolfo	Stolfo
Astorre	Astore	Astor
Atanasio	Attanasio
Ataulfo	Adaulfo	Adulfo
Atenodoro	Atendoro
Audenzio	Audenzo
Audomaro	Otmaro
Augusto	Augustino	Augustolo	Gusto	Tino
Aurelio	Lelio
Ausilio	Silio
Azaria	Azzaria
Azeglio	Azelio	Azzeglio	Azzello	Dazeglio	Dazelio	Zelio	Zelino
Azzo	Azo	Aza	Azzone	Ezzelino
Bacco	Bacolo
Bachisio	Bacchisio
Baciccia	Baciccin	Bacicin	Bacci
Baiulo	Baiolo
Balbino	Bino
Baldassarre	Baldassare	Baldessare
Baldo	Baldino	Balduccio
Baldovino	Baldoino	Balduino	Baudino	Baudolino	Baldo
Bando	Bandino	Bandinello	Bindo	Brando
Barlaam	Barlam	Barlamo	Barlamio
Barnaba	Barnabo	Bernabo
Barsaba	Barsabba
Barsanofio	Barsanufio	Barsanofrio	Barsanorio
Bartolomeo	Bartolommeo	Bortolomeo	Bartolo	Bortolo	Meo	Meio	Bartolino	Bortolino	Meuccio
Baruch	Barucco
Basilio	Basileo	Basile
Bassiano	Bassano
Basso	Bassillo
Battistino	Battista	Batista	Baciccia	Bati	Batino	Bista	Tista	Titta	Titti	Titty
Baudelio	Baudilio
Belisario	Bellisario
Bello	Bellino
Beltramo	Beltrame
Benedetto	Benito	Benedettino	Bettino	Benetto	Benedino
Benigno	Beneno
Benvenuto	Venuto	Nuto
Beppe	Beppi	Beppo	Bepi	Beppimo	Beppone	Pino
Berardo	Beraldo	Belardo	Verardo	Velardo	Verando	Veliardo	Berardino	Belardino	Verardino
Berengario	Beringhiero
Bernardo	Berardo	Bernardino	Dino
Bernolfo	Bernulfo
Bernwardo	Bernoardo
Berto	Bertillo	Bertino	Bertinello	Bertolo	Bertolino	Bertone
Bertoldo	Berto
Bertolfo	Bertulfo	Pertolfo
Bertrando	Beltrando	Berto
Biagio	Biaggio	Biasio	Biase	Biagino	Biasino
Bianore	Bianoro
Biondo	Biondino
Birillo	Berillo
Boezio	Boesio
Bonaccorso	Bonaccorsio	Bonaccursio	Bonaccurso	Buonaccorso	Buonaccorsio	Buonaccursio	Buonaccurso	Accursio	Corso
Bonaldo	Bonoaldo	Bonando
Bonamico	Buonamico	Amico
Bonaventura	Buonaventura	Ventura	Venturo	Venturino
Boncompagno	Buoncompagno	Compagno	Compagnetto	Pagno
Bonfante	Buonfante	Boninfante	Buoninfante	Bonfantino	Buonfantino	Fante	Fantino	Fantinello
Bonfiglio	Bonfilio	Buonfiglio	Buonfilio	Bonfigliolo	Buonfigliolo
Bonifacio	Bonifazio	Bonifacino	Facio	Fazio	Facino
Bono	Buono	Bonello	Bonetto	Bonino	Bonuccio	Bonito
Bonomo	Bonuomo	Buonuomo
Bononio	Bologno	Bolognetto	Bolognino
Bovo	Buovo	Bobo	Bobone	Bovone	Bualello
Brancaleone	Branca
Brando	Prando	Bando	Brandino	Brandolino	Brandisio	Brandizio
Braulio	Braulione
Brenno	Breno
Bretannione	Bretannio
Brizio	Bricio
Bruno	Brunone	Brunello	Brunetto	Brunino
Bruto	Uto
Burcardo	Brocardo	Boccardo	Broccardo	Bocciardo
Cafiero	Caffiero	Calfiero	Fiero
Calcedonio	Calciodonio
Callisto	Calisto
Calogero	Calocero	Gero	Gerino
Camillo	Cammillo	Millo	Lillo
Canio	Canione
Canzio	Canziano	Canciano	Canzianillo
Carlo	Carletto	Carlino	Carluccio	Carlomagno	Giancarlo
Carmelo	Carmine
Caro	Carino	Carissimo
Casimiro	Casimirro
Casto	Castolo	Castulo
Castore	Castorino
Catalano	Catelano	Talano
Cataldo	Catoaldo	Cataldino	Dino	Aldo
Catello	Catiello
Catone	Cato
Catullo	Catullio	Catulliano
Celestino	Celeste
Celio	Celino
Celso	Celsino
Cencio	Cencino	Cenco	Censo	Censino	Cenzo	Cenzino
Cesare	Cesarino
Cesario	Cesareo
Childerico	Ilderico
Ciriaco	Cirico	Chirico	Quirico	Quiriaco
Ciro	Cirio	Cirino
Clarenzio	Clarenzo
Claudio	Clodio	Claudino
Clemente	Clemenzo	Clemenzio	Clementino	Mentino	Cleme	Clemen
Cleofa	Cleopa	Clopa	Cleofino
Clodio	Claudio	Clodino
Colmano	Colomano	Colomanno	Colmanno
Colombano	Columbano
Colombo	Colombino
Cono	Conone	Cuono
Consalvo	Gonsalvo	Gundisalvo
Consiglio	Consilio
Contardo	Contaldo	Contardino
Corebo	Coroibo
Cornelio	Lelio
Corrado	Currado	Corradino	Dino
Corso	Corsino
Cosimo	Cosma	Cosmo	Cosmano	Cusmano	Cusumano	Gusmano	Cosme	Cosimino	Cosmino	Mimino	Mino	Mimmo
Costabile	Constabile
Costante	Costanzo	Costantino
Costantino	Tino
Costanzo	Costante	Constanzo	Costantino
Crescenzo	Crescenzio	Crescente	Crescenzino	Crescentino	Crescenzione	Enzo
Crisante	Crisanto	Grisante
Crisostomo	Grisostomo
Crispino	Crespino
Cristiano	Cristano	Christian	Cristian
Cristoforo	Cristofaro	Cristofero	Cristofolo	Cristofalo	Cristofano	Tofano	Tofo	Ciofo
Cuniberto	Cuniperto
Cutberto	Cudberto
Dacio	Dazio	Daciano
Dalmazio	Dalmazzo
Damiano	Addamiano
Damocle	Democle
Daniele	Danilo	Dani	Dany	Dadi	Lele
Dardano	Dardanio
Dario	Addario
Davide	Davidde	Davizzo	Davino
Decio	Desio
Defendente	Defendi	Defendo
Demetrio	Dimitri	Dimitrio
Desiderio	Desiderino	Derio	Derino	Desi	Desio
Diamantino	Diamante	Adamante
Diego	Addiego	Didaco
Dino	Dinetto
Diodoro	Diodorino
Dionigi	Dionisio	Dionigio
Dioscoride	Dioscuride
Dioscoro	Dioscuro
Disma	Dismo	Dimmo	Dimma	Dima	Dimo
Domenico	Dominico	Domenichino	Domenicuccio	Mimmo	Menico	Micuccio	Mico
Domizio	Domezio
Donato	Donatiano	Donatello	Donatino	Donatuccio
Donnino	Donino
Donnione	Domnione
Duilio	Aduilio
Durante	Durando	Durantino	Dante
Eberardo	Everardo	Everaldo	Evrardo
Eccardo	Eccarto
Edgardo	Edgaro
Edilio	Eduilio	Edovilio	Dilio	Dillo	Dilo	Ediliano
Edipo	Edippo
Edmondo	Eadmondo	Emondo	Edmo	Edmeo	Mondo
Edo	Edio	Edi	Edy	Edino
Edoardo	Eduardo	Odoardo	Adoardo	Edo
Edvino	Eduino
Efisio	Effisio
Efrem	Effrem	Efren	Efraim	Efrain	Efraimo	Efro
Egberto	Ecberto
Egidio	Egilio	Gilio	Giglio	Gill	Zilio	Gidio
Egisto	Gisto
Egizio	Egiziano	Egiziaco	Gizio	Giziano
Eligio	Ligio
Elio	Eleo	Elios
Eliodoro	Eleodoro	Alidoro
Eliseo	Liseo	Seo
Elmoldo	Elmoaldo
Elpidio	Erpidio	Alpidio	Idio
Elvezio	Elvetico
Elvio	Elvo	Elvi	Elvino	Elvidio	Elviano
Emanuele	Emmanuele	Manuele	Manuel	Manu	Lele	Manolo
Emidio	Emiddio
Emiliano	Massimiliano
Emilio	Emilietto
Ennio	Enio
Enrico	Errico	Arrigo	Anrico
Enzo	Enzio	Enzino
Epafrodito	Epafra
Epifanio	Epifano	Fanio
Erasmo	Eramo	Ermo	Elmo	Telmo
Erberto	Eriberto	Ariberto	Ariperto	Cariberto
Ercolano	Ercoliano	Erculiano
Ercole	Eracle	Ercolino
Ermacora	Ermagora
Ermanno	Ermano	Ermando	Armanno	Armano	Armando
Ermenegildo	Egildo	Gildo
Ermes	Ermete
Erminio	Ermino
Ernani	Ernano	Ernino
Ernesto	Ernestino	Erno	Tino
Espedito	Spedito
Esuperanzio	Esuberanzio	Esuberanzo	Essuperanzio	Esuperanzo	Superanzio	Esu
Esuperio	Essuperio
Etelberto	Edelberto	Edilberto
Etelredo	Aelredo
Ettore	Ettorino	Ettoruccio
Eudemo	Eudemio
Eugenio	Geo	Gegio	Gene	Genio	Enio
Eugrafo	Eugrafio
Eumene	Eumenio
Euplio	Eupilio	Euplo
Euprepio	Eupreprio	Eupremio
Eusebio	Eusepio
Eustachio	Eustacchio
Eustasio	Eustazio
Eutichio	Eutico	Euticchio	Eutizio	Euticio	Eutichiano
Evaldo	Evardo
Evandro	Vandro
Evangelista	Evangelisto	Vangelista
Evangelo	Evangelio	Evangelino
Evaristo	Varisto
Evenzio	Evenzo
Ezechiele	Ezechiello
Ezzelino	Eccelino	Ezelino	Azzolino
Facondo	Facondino
Falco	Falcone	Falconetto
Faliero	Falerio	Falliero	Fallero
Fausto	Faustino
Fedele	Fidelio	Fedelino
Federico	Federigo	Frederico	Fedrico	Fede	Fedo	Rico	Chico	Chicco	Fredo	Fedi
Feliciano	Feliziano	Liciano
Ferdinando	Fernando	Ferrando	Ferrante	Fernandino	Ferdi	Nando
Fermo	Firmo
Ferrante	Ferrando	Ferrantino
Ferruccio	Ferruzio
Fidenzio	Fidenzo
Fido	Fidaldo	Fidalmo	Fidardo	Fidalino
Filadelfo	Filadelfio	Filodelfo	Filelfo
Filarete	Filoreto
Filippo	Filippino	Filippello	Lippo	Pippo
Filoteo	Teo
Fioravante	Fieravante	Fioravanti	Fioravanzo	Vante
Fiorentino	Florentino
Fiorenzo	Fiorente	Florenzio	Florenzo	Florento	Fiorenzino	Fiore	Renzo	Enzo
Firmino	Fermino	Firminio	Firmio
Florestano	Forestano
Foca	Foco
Folco	Fulco	Fulgo	Folchetto	Fulcone
Fortunato	Affortunato
Fosco	Fusco	Foscaro	Foscarino	Foscolo
Fozio	Fotino
Francesco	Franceschino	Francescuccio	Francescuzzo	Franco	Fra	Franci	Cesco	Cecco	Cecchino	Cesto	Fresco	Chicco	Sisio	Checco	Ciccio	Cuccio
Franco	Gianfranco	Pierfranco
Frontone	Frontino
Fulceri	Fulcieri	Fulgero	Fulcherio
Fulgenzio	Fulgenzo
Gabriele	Gabbriele	Gabriello	Gabbriello	Gabri	Gabrio	Lele	Gello	Bello
Gaetano	Tano
Gaio	Caio
Galeazzo	Galasso	Galeotto
Galliano	Galiano	Gagliano	Galleano	Galeano	Gallieno	Galieno
Gallo	Gallio	Galliano
Galvano	Galgano	Gano
Gandolfo	Gandolfino
Garibaldo	Garibaldi	Garibaldino	Gerboldo	Gerbaldo	Giribaldo
Gaspare	Gasparo	Gaspero	Gasparre	Gasparro	Gasparri	Gasparino	Gasperino	Parri
Gaudenzio	Gaudenzo	Enzio
Gavino	Gabino	Gabinio	Baingio
Gebardo	Gebeardo
Gelindo	Gilindo	Zelindo
Gemello	Gemino	Geminio	Gemisio
Geminiano	Gemiliano	Gemigniano	Gimignano
Genesio	Genisio	Ginesio	Ginnesio	Gineto
Gennaro	Gianuario	Genuario	Gennarino	Rino
Gerardo	Gherardo	Girardo	Gerardino	Gerino	Gaddo	Gardo	Galdo	Galdino
Gerasimo	Gerasio
Gerlando	Gernardo	Girlando	Lando
Germano	Germanino
Gero	Geri
Geronzio	Geronte
Gervasio	Gervaso	Gerbasio
Gesu	Gesuino	Gesumino	Gesuello
Getulio	Gettulio
Ghino	Ghinotto
Giacobbe	Giacobo	Giacomo	Jacopo	Iacopo
Giacomo	Jacomo	Giacobbe	Jacopo	Iacopo	Giaime	Giacomino	Giacominuccio	Giacometto	Giacomello	Mino	Como
Giangiacomo	Giangi
Gianmarco	Giammarco
Gianmaria	Giammaria
Gianmario	Giammario
Gianni	Giani	Gianno	Giannino	Giannello	Gianello	Giannetto	Gianetto	Giannico	Giannotto	Giannozzo	Gian	Nino	Gianbattista	Giancarlo	Gianfranco	Gianluca	Gianluigi	Gianmarco	Gianmaria	Gianmario	Gianpaolo	Gianpiero	Gianpietro
Gianpaolo	Giampaolo
Gianpiero	Giampiero
Gianpietro	Giampietro
Gigi	Gigio	Gigino	Gigetto	Gigiotto
Gilberto	Gilbertino
Gino	Ginetto
Gioacchino	Gioachino	Giacchino	Giachino	Giovacchino	Iachino
Giocondo	Giocondino
Gioele	Gioiele	Gio	Gioi	Gioe
Giorgio	Georgio	Iorio	Giorgione	Giorgino	Giorgetto	Gino	Piergiorgio
Giosafat	Giosafatte	Giosaffatte	Giosafatto	Giosaffatto	Giosefatto	Giosofatto
Giosue	Gesue	Giosuele	Gesuele
Giovanni	Iovanni	Giovannino	Giovannico	Gianni	Nino	Ianni	Nanni	Vanni	Zanni
GiovanBattista	Baciccia	Giambattista	Gianbattista	Giobatta
Giovita	Giovito
Giraldo	Gheraldo	Geraldo	Gelardo	Gilardo	Galardo
Girolamo	Gerolamo	Geronimo	Geromino	Momo	Momolo
Gisleno	Gisileno
Gismondo	Ghismondo	Ghismundo
Giuda	Giudo
Giuliano	Uliano
Giulio	Giulietto
Giuseppe	Gioseffo	Giuseppino	Beppe	Peppe
Glauco	Clauco
Glicerio	Clicerio	Licerio
Goffredo	Gottifredo	Fredo
Gonario	Gonnario
Gontrano	Gontranno	Gontrando	Contrano
Gorgonio	Gorgo
Gottardo	Gottardino
Gregorio	Gregorino	Gregoriello	Gorio	Goro	Gorello	Goretto	Gorino	Goriano
Grimaldo	Grimoaldo
Gualberto	Valberto	Valperto
Gualfredo	Gualfredi	Valfredo	Valfrido	Walfredo	Walfrido	Gualfardo	Valfre
Gualtiero	Gualterio	Gualtieri	Walter	Walther	Valter	Valtero	Valtere	Valterio	Waltiero	Valtiero	Valterino	Walterino
Guarino	Guerino	Guerrino	Varino
Guarniero	Guarnieri	Guarnero	Guarnerio	Varniero	Varnero	Irnerio	Inerio	Neri
Guelfo	Guelfino	Guelfuccio	Fuccio
Guglielmo	Gulielmo	Vilelmo	Villelmo	Villermo	Guglielmino	Guglielmotto	Elmo	Gughi	Gelmo	Gelmino	Gilmo	Ielmo	Gugli	Lemmo	Lemo	Memmo	Memo	Mino	Nelmo	Glielmo	Velmo	Velmino	Vilio	Zelmo	Zelmino
Guido	Guidone	Guittone	Guidotto	Guidetto	Guidolino	Guidiccino	Guiduccio	Dotto	Cino
Guiscardo	Guicciardo	Guizzardo	Viscardo	Guicciardino
Gustavo	Gustavino
Iago	Jago	Yago
Icaro	Icario
Igino	Iginio
Ilario	Ilaro	Illario	Ilariano	Ilarione	Ilarino
Ildebrando	Ildeprando	Ildebrandino	Bando	Brando
Ildefonso	Idelfonso
Imerio	Imero	Imer
Ingenuino	Ingenuo	Genuino
Innocenzo	Innocenzio	Innocente	Innocentino
Iorio	Jorio
Ippazio	Ipazio
Ireneo	Irenione	Reneo
Isamberto	Isanberto	Isemberto	Isenberto	Isambardo	Isanbardo	Isembardo	Isembarto	Isimbardo
Isidoro	Isodoro	Sidoro
Italo	Italiano	Italino
Ivan	Ivano
Ivanhoe	Ivanoe	Ivaone
Ivano	Ivanio	Ivanne
Ivo	Ivio	Ives	Ivone	Ivonio	Ivonetto	Ivetto
Jacopo	Iacopo	Giacobbe	Giacomo	Jacopino	Jacopone	Iacopino	Iacobino	Iacopone	Coppo	Iaco	Lapo	Pino	Bino	Puccio	Pazzo	Pazzino
Jader	Iader
Jafet	Iafet
Josto	Iosto
Ladislao	Vladislao
Laerte	Laerzio
Lamberto	Lamperto	Amberto	LAmbertino	Lambertuccio
Lancillotto	Lanciotto	Lancellotto	Lanzerotto
Lando	Landino	Landuccio
Landolfo	Lando
Lapo	Papo	Papino
Lauro	Laurino	Laurello	Laurindo	Laurano	Lauriano	Laureano	Laureato
Lazzaro	Eleazaro
Leandro	Aleandro
Learco	Alearco
Leo	Leoluca
Leodegario	Ludgario	Ludgero	Lugdero
Leoluca	Leoluchino
Leonardo	Lionardo	Leo	Nardo	Nardino	Leonardino
Leone	Leonio	Lionello	Leonetto	Lionetto	Leonino	Leoncino	Leon	Leo
Leonzio	Leontino
Leopardo	Leobardo	Leopardi
Leopoldo	Leopoldino	Leo	Poldo
Lepido	Lepo
Letterio	Leterio	Litterio	Lettero	Letterino
Leucio	Leuzio	Leucone
Liberio	Liborio
Libero	Liberino
Lido	Lidio	Lidiano
Lillo	Lillio	Lilli	Lillino
Lino	Linuccio
Lionello	Leonello
Liutprando	Luitprando	Ludbrando
Livio	Livo	Livino	Livietto
Lorenzo	Laurentino	Lorentino	Lorenzino	Loris	Renzo	Cencio	Enzo	Zino
Luca	Luchino	Luchetto	Lu	Gianluca	Leoluca	Lucantonio
Lucano	Luca
Luciano	Lucianino	Lucio	Ciano	Cianetto
LUcido	Lucidio
Lucilio	Lucilia
Lucio	Lucillo	Lucino	Luciolo	Lucietto	Lucione
Ludovico	Lodovico	Ludo	Vico
Luigi	Aligi	Aloisio	Alvise	Clodoveo	Ludovico	Luigio	Luigino	Gigi	Gino	Gianluigi	Pierluigi
Lupo	Lupicino
Macedonio	Macedone
Maclovio	Macuto
Maffeo	Maffio	Feo
Maggio	Maggino	Maggiolino
Maggiorino	Maggiore
Magnerico	Meinrico
Mainardo	Meinardo	Maghinardo	Maginardo
Mamante	Mammante	Mama	Mamete	Mammolo	Mamolo
Mamerto	Mamerte
Mamilio	Mamillo
Manetto	Mainetto
Manfredo	Manfredi	Maino	Fredi	Manfredino
Manlio	Manilo
Manno	Mannone	Mannuccio	Manetto
Marcellino	Cellino	Celino	Lino
Marcello	Lello	Marcellino
Marciano	Marziano
Marco	Marcolino	Marcuccio	Marchino	Marchetto	Gianmarco	Marcantonio	Marcaurelio
Marcovaldo	Marcoaldo
Marino	Marinello	Marinuccio	Rino
Mario	Marietto	Mariolino	Marione	Gianmario
Marquardo	Marcoardo
Marsilio	Marsiglio	Marzilio	Silio
Martino	Marti	Tino	Martinello	Martinetto
Maruta	Marota
Marx	Marse	Marxino
Marzio	Marzino	Marsino
Massenzio	Masenzio
Massimiano	Max
Massimiliano	Max	Massi
Massimino	Max
Massimo	Massimino	Massimillo	Max	Massimiliano
Matteo	Mattia	Maffeo	Mazzeo	Teo
Maturo	Maturio	Maturino
Maurilio	Maurelio
Maurizio	Mauri
Mauro	Maurino	Mauretto	Maurello
Max	Massi
Medardo	Metardo	Dardo
Meinrado	Mainrado	Meginrado
Melanippo	Menalippo	Melanippia
Melasippo	Melesippo	Meleusippo
Melchiorre	Melchiore	Melchior
Melchisedech	Melchisedecco	Melchidesech	Melchidesecco
Melezio	Meleto
Mellito	Melito	Melitone	Melitino
Memmo	Memo
Memnone	Mennone
Menenio	Menigno
Menotti	Menotto
Mentore	Mentorino
Michele	Micaele	Michelino	Michi	Lele	Chello	Chelino	Lino	Michelangelo
Milko	Milco
Milone	Milo
Milvio	Milvo	Milvano
Milziade	Melchiade
Mimmo	Mimmia	Mimmino	Mimi
Mirko	Mirco
Miro	Mirino
Miroslavo	Miroslao	Mirko	Miro
Misaele	Misa
Modesto	Modestino
Monaldo	Monoaldo	Monardo	Modoaldo	Naldo
Morando	Morante
Moreno	Reno
Mose	Moise
Muziano	Muciano
Nabor	Naborre	Nabore
Naldo	Naldino
Nanni	Nani	Nannino
Napoleone	Napoleoncino	Napo	Nappo	Napolino
Narciso	Narcisio	Narcisso
Natale	Natalio	Natalizio	Natalino
Natanaele	Nataniele
Nazario	Nazzario	Nazaro	Nazzaro	Nazzarino
Nazzareno	Nazareno
Nedo	Nedio
Neemia	Nehemia
Nemesio	Nemezio
Nemorino	Nemore	Nemorio
Neofito	Neofita
Nepomuceno	Nepomiceno
Nereo	Nerio
Neri	Nerino
Nestore	Nestorio
Nevio	Neviano	Nevilio	Nevino
Nicandro	Nicardo
Niceta	Niceto
Nicodemo	Niccodemo	Nico
Nicola	Niccolo	Nicolo	Nicolao	Nicolas	Nicolino	Nicoletto	Nico	Nicco	Cola
Nicomede	Nico
Nino	Ninetto	Ninuccio	Nini	Niny	Ninni	Ninny
Nono	Nonio
Norberto	Nolberto	Noberto	Berto
Normanno	Normando
Novenio	Novemio	Novembrino
Oberdan	Oberdano	Oberedan	Pberdino	Oberdanch	Oberdank	Oberdanco	Oberedank	Hoberdan	Oberdante
Obizzo	Obizio	Obizo	Opizio	Opizzo	Obizzone	Opizzone	Obizzino	Opizzino
Oceano	Oceanio
Oddone	Odone	Oddo	Odo	Ottone	Otto	Oto	Oddino	Odino	Ottorino	Otino
Odoacre	Ottocaro
Odorico	Oderico
Olao	Olavo	Olaf	Olav
Olindo	Olinto
Oliviero	Oliverio	Olivieri	Uliviero	Livieri	Liviero	Vieri	Viero
Ollegario	Olegario
Omobono	Omobuono	Uomobuono
Onelio	Oneglio	Onello
Onorio	Onorino
Opilio	Opillo	Opilione
Orenzio	Orienzio
Oreste	Orestino
Orlando	Rolando	Orlandino	Lando
Ormisda	Ormisde
Oronzo	Oronzio	Oronzino
Orso	Urso	Orsino	Ursino	Orsetto	Ursone	Ursicino
Oscar	Auscario	Oscare	Oscarre	Oscher	Oscardo	Oscaro	Oscarino	Oscherino
Osiride	Osiri	Osiris	Osilide
Osmondo	Osmundo	Asmundo
Osvaldo	Oswalda	Osualdo	Svaldo
Otello	Tello
Ottato	Optato
Ottaviano	Ottavante	Attaviano	Attavante
Ottavio	Ottavo	Ottavino
Pagano	Paganello	Paganino
Palmiro	Palmerio	Palmiero	Palmero	Palmerino	Palmierino	Palmarino	Miro
Pancrazio	Pangrazio	Brancazio	Branca
Panfilo	Panfilio	Pamfilo
Pantaleone	Pantalone	Pantaleo
Paolo	Polo	Pagolo	Pavolo	Paolino	Paolone	Paoletto	Paolotto	Paoluccio	Paolillo	Lino	Lotto	Lillo	Gianpaolo	Pierpaolo
Paride	Paris	Parisio	Parise	Pariso	Parigi	Parisino	Parigino
Parmenio	Parmenione	Parmenone	Enio
Pasquale	Pascasio	Pasqualino
Pellegrino	Pellegro	Pino	Rino
Peppe	Peppo	Peppi	Pepo	Peppino	Peppone	Peppuccio	Peppinello	Peppiniello	Pino	Nello
Piero	Pier	Pierino	Pierotto	Pierangelo	Pierantonio	Piercarlo	Pierfrancesco	Piergiorgio	Pierluigi	Piermaria	Pierpaolo
Pietro	Piero	Pietrino	Petrone	Petroncino	Pietrangelo	Pietrantonio
Pino	Pinuccio	Pinello	Pinetto
Pipino	Pino
Placido	Placidio	Placidino
Policarpo	Policarpio
Poliuto	Polieuto	Polieutto	Polieutte
Pompeo	Pompeio
Pompilio	Pilio
Porfirio	Porfidio	Porfilio
Potito	Tito
Primo	Primetto	Primino	Primiano
Prisco	Priscillo
Procolo	Proculo	Broccolo
Prospero	Prosperino	Rino
Prudenzio	Prudente
Publio	Pubblio
Puccio	Pucci
Quarto	Quartino	Quartillo
Quinto	Quinzio	Quintino
Quirino	Querino
Radames	Redames	Radamise
Raffaele	Raffaello	Raffaelino	Raffaellino	Lele	Lello	Raffo	Raffa
Raimondo	Rimondo	Raimondino	Rimondino	Raimondello	Mondo	Mondino	Mondilio
Rainardo	Reinardo
Rambaldo	Baldo
Ramberto	Ramperto
Ramsete	Ramesse
Randolfo	Ranulfo
Raniero	Ranieri	Rainiero	Rainerio	Rainieri	Raineri	Riniero	Ranuccio	Neri	Nero
Raul	Raulo	Raoul	Raolo	Rao
Redento	Redente	Redenzio	Redentino
Regolo	Regulo
Remo	Remolo
Renato	Rene
Riccardo	Ericardo	Ricardo	Ricciardo	Riciardo	Ricoardo	Ricordano	Rizzardo	Riccardino	Riccarduccio	Cardo	Ciardo	Cardino	Riccy
Ricciotti	Ricciotto
Rigoberto	Ricoberto
Rinaldo	Ronaldo	Rainaldo	Reginaldo	Riginaldo	Rinaldino	Rinalduccio	Naldo	Nado
Rino	Rinello	Rinetto	Rinuccio
Riziero	Rizieri	Riziere	Rizziero	Rizzieri	Rizerio	Rizzerio	Rezerio	Rezieri	Risiero	Risieri
Roberto	Ruperto	Robertino	Berto	Robi	Roby	Rob
Rocco	Rocchino	Rocchetto
Rodolfo	Ridolfo	Rudolfo	Radolfo	Rodolfino	Rudi	Rudy	Rody	Dolfo	Fino
Rodrigo	Roderigo	Roderico	Ruderico	Rodorico	Rodri
Rolando	Rollando	Orlando	Lando	Ando
Romolo	Romolino
Romualdo	Romoaldo	Rumoldo
Rosario	ROsarino	Saro	Sario	Saretto	Sarino
Ruben	Rubens	Rubes
Rufino	Ruffino
Rufo	Ruffo	Rufino	Rufillo	Ruffillo
Ruggero	Ruggiero	Roggero	Ruggeri	Geri	Gero
Rustico	Rusticolo	Rustichello	Rustichiello	Rusticiano	Chiello
Rutilio	Rotilio	Rutilo	Rutolo
Saba	Sabba
Sabato	Sabbazio	Sabatino	Sabbatino	Sabadino	Sabbadino
Sadoc	Sadoch	Sadok
Sallustio	Salustio
Salomone	Salamone	Solimano
Salvatore	Salvadore	Salvatorico	Salvatorino	Salvato	Salvo	Tore	Turi	Turiddu	Dore	Rino	Sasa	Toto
Salvo	Salvio	Salvino	Salvetto	Salvuccio
Sandro	Sandrino
Sante	Santi
Santo	Sante	Santi	Santino	Santuccio	Santuzzo	Santillo	Santolo
Santoro	Santorre	Santorio
Satiro	Satirio	Saturio
Saturnino	Nino
Saturno	Saturnino
Saul	Saulo	Saule	Saulle
Saverio	Zaverio	Saverino
Savio	Savino
Scipione	Scipio
Sebastiano	Bastiano	Seba
Secondo	Secondario	Secondolo	Secondillo	Secondino
Sedecia	Zedechia
Seleuco	Zaleuco
Sennen	Senen
Serapione	Serapio
Sergio	Sergino
Servilio	Serviglio
Servio	Servolo
Sestilio	Sistilio
Sesto	Sestio	Sisto	Sestino
Settimo	Settimino
Severino	Severiano	Rino
Severo	Severio	Severino
Sigfrido	Sigfredo	Sifrido	Sigifrido	Sigifredo	Sigefredo	Sigefrido	Sigilfrido	Sigilfredo	Sigisfrido	Sigisfredo	Silfrido	Siffredo
Sigismondo	Sigismundo	Sismondo	Gismondo	Mondo	Mondino
Silio	Silo
Silverio	Verio
Silvestro	Salvestro
Silvio	Silvo	Selvo	Silvietto	Silvino	Selvino
Simone	Simeone	Simeo	Simoncello	Simonello	Simoncetto	Simonetto	Simoncino	Simonino	Simo	Mone	Mona	Cino	Cello	Cetto
Simplicio	Semplicio
Siro	Sirio	Siride	Sirino
Sisinnio	Sisinio	Sisinno	Sisino
Sofronio	Sofrone
Sossio	Sosso	Sosio
Sotero	Sotere
Sperandio	Sperandeo	Sperindio	Sperando	Sperandino
Spiridione	Spiridone
Spurio	Spurino
Stanislao	Stanislavo	Stano	Stanis
Stefano	Stefanio	Stefanino	Steno
Stelio	Stellio	Stiliano	Estelio
Steno	Steo	Steto	Teno	Teto
Sulpicio	Sulpizio
Taddeo	Addai
Tano	Tanino	Tanuccio	Tanuzzo
Tarcisio	Tarciso	Tarsicio	Tarsizio
Tarquinio	Tarquino
Tarsilio	Tarsillo
Temistocle	Temisto
Teobaldo	Tebaldo	Tibaldo	Teo	Baldo
Teodemaro	Teodemiro	Teo
Teodorico	Teo
Teodoro	Teo	Doro	Dorino
Teodulo	Teodolo
Teofane	Teofanio	Teo
Teofilatto	Teofilato	Tafiletto
Teofilo	Teo
Terenzio	Terenzo
Terzo	Terzio	Terziano	Terzilio	Tersiglio	Terzillo
Tiberio	Tiberino
Timoleone	Timoleonte
Timoteo	Teo
Tindaro	Tindario	Tindareo
Tino	Tinuccio
Tito	Titino
Tobia	Tobias	Tobiolo
Tolomeo	Tolommeo
Tomislao	Tomislavo
Tommaso	Tomaso	Tomasso	Tommasino	Tomasino	Tomassino	Maso	Masino	Massino	Masolino	Misino	Mino	Tom
Tonio	Toni	Tonino	Tonello	Toninello	Toniolo	Tono	Tony
Tranquillo	Tranquillino
Trento	Trentino
Trifone	Trifonio	Trifoso	Triffone
Tullio	Tulio	Tullo
Turibio	Turribio
Ubaldo	Uboldo	Ubaldino	Ubaldello	Ubalduccio	Baldo	Dello
Uberto	Oberto	Ugoberto	Ubertino
Ugo	Ughino	Ugolino	Ugone	Ughetto	Uguccio	Uguccione	Ghino
Uliano	Oliano
Ulisse	Odisseo
Ulrico	Udalrico	Ulderico	Uldarico	Udalrigo	Ulderigo	Odalrico	Olderico	Olderigo	Olderigi	Dorico	Dorigo	Dorligo
Ultimo	Ultimio	Ultimino
Umberto	Umbertino
Umbro	Umbrio
Umfredo	Unfredo	Umfrido	Unfrido	Umperio
Uriele	Uriello	Uriel
Ursicino	Ursicio
Valdemaro	Valdimaro	Waldemaro
Valdo	Gualdo	Waldo	Valdino	Waldino
Valente	Valento	Valenzo	Valenzio	Valentino
Valentino	Tino	Vale
Valerico	Valarico	Gualarico
Valerio	Valiero	Valerino
Vanni	Wanni	Vanno	Vani	Vanino	Vannello	Vannetto
Venanzio	Venanzo	Venazio
Venceslao	Venceslavo	Vinceslao	Vincislao
Venerio	Veniero
Vermondo	Varmondo	Veremondo
Vero	Wero	Verio	Verino	Verissimo
Veturio	Vetulio	Vetulo
Vezio	Vezzolo
Vicinio	Vicino
Vilfredo	Vilfrido	Guilfrido	Wilfredo	Wilfrido
Viliberto	Villiberto	Vilberto
Villibaldo	Vilibaldo	Villebaldo
Vincenzo	Vincente	Vicenzo	Vincenzio	Vincenzino	Vicenzino	Cencio	Enzo	Vince	Vinci	Venzo	Cenzo	Censo	Cenzino	Censino
Vinfredo	Vinfrido
Vinicio	Venicio
Virgilio	Vergilio	Vergiglio
Virginio	Verginio
Vitale	Vitalio	Vitalino
Vittorio	Vittore	Vettore	Vittorino
Vivaldo	Vivaldi
Vivenzio	Vivante	Vivenziolo
Vivo	Vivio	Vivetto	Vivino
Vladimiro	Wladimiro	Vladimir	Wladimir
Volfango	Wolfango	Volfgango
Volfardo	Vulfardo
Volframo	Volfrano	Wolframo	Wolfrano	Vulfranno
Voltero	Voltaire
Werther	Werter	Verther	Verter
Xanto	Xante
Yuri	Iuri	Juri	Jury	Jurij	Yari
Zabulon	Zabulone
Zaccheo	Zacheo	Zacai
Zaffiro	Zafiro	Saffiro
Zebedeo	Zebedia
Zeffiro	Zefiro	Zefirino	Zeffirino
Zefirino	Zeffirino	Zeferino	Zefferino
Zeno	Zenone	Zenio
Zenobio	Zanobio	Zanobi	Zenobi	Zenebi
Zeus	Zeusi
Zoilo	Zoello