Abigail	Abbie	Abby	Gail	Nabby
Ada	Adie
Adelaide	Addie	Adela	Dell	Della	Heidi
Adele	Adelle	Adela	Addie	Dell	Della
Adeline	Adelina	Adaline	Addie	Aline	Dell	Della
Adrienne	Adriana	Adie
Agatha	Aggie
Agnes	Aggie	Ness	Nessie
Aileen	Eileen	Alene	Allie	Lena
Alana	Allie	Lana
Alberta	Allie	Bertie
Albertina	Albertine	Allie	Bertie	Tina
Alexandra	Alexandria	Alex	Alix	Alexa	Alla	Allie	Ali	Lexy	Sandra	Sandy
Alexis	Alex
Alfreda	Alfie	Alfy	Frieda	Freda	Freddie	Freddy
Alice	Alicia	Alyce	Alisa	Alissa	Alyssa	Allie	Ally	Ali	Elsie	Lisa
Alison	Allison	Alyson	Allyson	Allie	Ally	Ali
Althea	Thea
Alvina	Alvena	Vina	Vinnie	Vinny
Amanda	Mandy
Amelia	Amalia	Amy	Millie	Milly
Amy	Aimee	Amie
Anastasia	Ana	Stacy	Stacey
Andrea	Andy
Angela	Angelica	Angelina	Angeline	Angel	Angie
Anita	Ana	Nita
Anna	Ann	Anne	Ann	Annie	Nancy	Nancie	Nance	Nan	Nana	Nanny	Nanette	Nannette	Nina
Annabel	Annabelle	Anabel	Ann	Anna	Bel	Belle	Bell
Annette	Annetta	Annie	Netta	Nettie	Netty
Anthea	Thea
Antoinette	Nettie	Netty	Net	Netta	Toni	Tony	Toy	Toi
Antonia	Toni	Tony	Tonya	Tonia
Arabella	Arabel	Arabelle	Bel	Bell	Belle	Bella
Arlene	Arline	Arleen	Arlyne	Lena	Arly	Lynn
Ashley	Ash
Audrey	Audra	Audie	Dee
Augusta	Aggy	Augie	Gussie	Gusta	Gusty
Augustina	Aggy	Augie	Gussie	Gusta	Gusty	Ina	Tina
Aurora	Orrie	Rori
Barbara	Bab	Babs	Babbie	Barbie	Babette
Beatrice	Beatrix	Bea	Bee	Beattie	Trixie	Trissie	Trissy
Belinda	Bel	Bell	Belle	Linda	Lindy	Lin	Lynn
Belle	Bell	Bel	Bella	Annabel	Arabella	Isabel	Rosabel	Belinda
Berenice	Bernice	Bernie
Bertha	Berta	Bertie
Beverly	Beverley	Bev
Blair	Blaire
Blanche	Blanch
Blythe	Blithe
Bonnie	Bonny
Brenda	Brendie	Brandy
Brett	Bret	Bretta
Bridget	Bridgette	Brigid	Brigit	Biddie	Biddy	Bridie	Bridey	Brie	Bree	Brita
Brittany	Brittney	Britney	Brit	Britt	Brita	Brie
Camille	Camilla	Camile	Camila	Cammie	Cammy	Millie
Candace	Candice	Candy
Caren	Carin	Caryn	Carrie
Carla	Carlie	Carly	Caroline
Carlotta	Carlota	Lotta	Lottie	Lotty	Charlotte
Carol	Carole	Carrol	Carroll	Karol	Carrie	Carry	Caroline
Caroline	Carolyn	Carolina	Carlyne	Carline	Karoline	Carrie	Carry	Caddie	Caddy	Carlie	Carly	Callie	Cally	Carol	Lynn	Lynne	Lin	Lina
Cassandra	Cass	Cassie	Cassey	Casey	Sandra	Sandy
Catherine	Cathryn	Catheryn	Catharine	Cathleen	Cat	Cattie	Catty	Cathie	Cathy	Cassie	Kit	Kitty	Kittie
Cecilia	Cecillia	Cecelia	Cecile	Cecily	Cicely	Cis	Cissy	Sissy	Celia
Celeste	Celie	Lessie
Celestine	Celestina	Celie	Lessie	Tina
Celia	Celie	Cel
Celine	Celina	Selina
Charity	Chattie	Chatty	Cherry
Charlene	Charleen	Charline	Charlyne	Charlie	Lynn
Charlotte	Lotta	Lottie	Lotty	Lola	Lo	Lolita	Chattie
Cheryl	Cherie	Cheri
Christine	Christina	Christiana	Christian	Chris	Christy	Christie	Christa	Chrissie	Kit	Tina
Clara	Claire	Clare	Clair
Clarice	Clarissa	Clara	Clare	Clair
Claudia	Claudine	Claudette	Claudie
Clemency	Clem	Clemmie
Clementine	Clementina	Clem	Clemmie	Tina
Colleen	Coleen	Lena
Constance	Connie	Conny	Connee
Cora	Cori	Corrie	Corey	Cory
Cordelia	Cordy	Cori	Delia
Corinne	Corinna	Corynne	Corrine	Corine	Corina	Cora	Cori	Corrie	Cory
Cornelia	Connie	Conny	Corny	Cori	Nell	Nellie
Courtney	Court	Courtie
Crystal	Chrystal	Crys	Chris
Cynthia	Cindy
Daisy	Daysie
Danielle	Daniela	Dani	Danny
Daphne	Daph	Daphie
Darlene	Darleen	Darlyne	Lena	Darla
Deborah	Debbie	Debby	Debra
Delia	Dell	Della
Delilah	Dell	Della	Lila
Dell	Della	Adelaide	Adele	Adeline	Delia	Delilah
Denise	Denice	Denyse	Denny
Diana	Diane	Dianne	Di
Dinah	Dina	Di
Dolores	Delores	Lola	Lolita	Dolly
Dominique	Dominica	Minnie	Nicki	Nikki
Dora	Dorrie	Dori	Dorothy
Doreen	Dorene	Dorrie
Doris	Dorris	Dorrie
Dorothy	Dorothea	Dora	Dorrie	Doll	Dolly	Dodie	Dot	Dottie	Dotty	Dee
Edith	Edyth	Edythe	Edie	Edye	Dee
Edna	Eddie
Elaine	Alaine	Helaine	Ellie	Elly	Lainie
Eleanor	Elinor	Eleonora	Eleonore	Elenore	Ella	Ellie	Elly	Nell	Nellie	Nelly	Nora	Lally	Lallie
Elisa	Eliza	Elisia	Elissa	Elise	Elyse	Elsa	Elsie
Elizabeth	Elisabeth	Betty	Bettie	Bet	Bett	Bette	Betta	Betsy	Betsey	Betsi	Beth	Bettina	Eliza	Ellie	Elly	Ilse	Liz	Lizzy	Lizzie	Liza	Lisa	Lise	Lisette	Lizette	Lisbet	Lizbeth	Libby
Ella	Ellie	Elly	Nellie	Nelly	Eleanor	Elaine	Helen
Ellen	Helen
Eloise	Heloise	Lois
Elvina	Elvine	Vina	Vinnie	Vinny
Elvira	Alvira	Elvie	Elva
Emily	Emilie	Emilia	Em	Emmy	Emmie	Millie	Milly
Emma	Em	Emm	Emmy	Emmie
Erica	Erika	Ericka	Ricky	Rickie
Ernestine	Earnestine	Erna	Ernie	Tina
Estella	Estelle	Essie	Essy	Stella
Esther	Ester	Hester	Essie	Essy	Ettie	Etty	Hettie	Hetty	Hessy
Ethel	Eth
Etta	Ettie	Etty	Henrietta	Esther	Loretta	Marietta
Eugenia	Eugenie	Gene	Genie
Eulalia	Eula	Lally	Lallie
Eunice	Euny	Eunie
Euphemia	Euphemie	Effie	Effy	Euphie	Phemie
Eustacia	Stacy	Stacey	Stacia
Eve	Eva	Evie
Eveline	Evelyn	Evelynne	Eveleen	Evelina	Eve	Evie	Evvie	Lynn
Evangeline	Evangelina	Eve	Evie	Angie	Lynn
Faith	Fae	Fay	Faye
Felicia	Felicity	Felice	Fee	Fel
Florence	Flo	Floy	Floss	Flossie	Flossy	Flora	Florrie
Frances	Fan	Fannie	Fanny	Fran	Frannie	Franny	Francie	Francy	France	Frankie	Franky
Francesca	Francisca	Fran	Cesca
Francine	Fan	Fannie	Fanny	Fran	Frannie	Franny	Francie	Francy	France	Frankie	Franky
Frederica	Frederika	Fredericka	Freda	Freddie	Freddy	Ricky	Rickie
Gabrielle	Gabriela	Gabriella	Gabby	Gabi	Gaby
Genevieve	Gene	Ginny	Jenny	Viv
Georgina	Georgine	Georgie	Gina
Geraldine	Gerry	Gerrie	Gerri	Jerry	Dina
Gertrude	Gertie	Trudie	Trudy
Gillian	Jillian	Jill
Gina	Regina	Georgina
Gladys	Glad
Glenda	Glen
Gloria	Glory
Goldie	Goldy
Grace	Gracie
Gwendolen	Gwendolyn	Gwen	Gwenda	Wendy
Hannah	Hanna	Ann	Annie	Nana	Nanny
Harriet	Hattie	Hatty
Heather	Hettie	Hetty
Helen	Helena	Elena	Ellen	Nell	Nellie	Nelly	Ellie	Elly	Lena	Lala	Lally	Lallie
Henrietta	Etta	Ettie	Etty	Hettie	Hetty	Nettie	Netty
Hester	Esther
Hilary	Hillary	Hill	Hillie	Hilly
Hilda	Hylda	Hildie
Honora	Honoria	Honor	Nora	Norah	Honey
Imogen	Imogene	Immy	Immie
Irene	Renie	Rena
Irma	Erma
Isabel	Isabelle	Isabella	Bel	Bell	Belle	Bella	Issy	Izzy	Tibbie
Isadora	Isidora	Issy	Izzy	Dora
Jacqueline	Jacquelyn	Jackie	Jacky
Jamesina	Jamie	Jayme	Jaime
Jane	Janie	Janey	Jenny	Jennie	Jen	Janet
Janet	Janette	Janetta	Jan	Nettie	Netty	Netta
Janice	Janis	Jenice	Jan
Jean	Jeanne	Jeanie	Jeannie
Jeannette	Jeannetta	Jeanette	Jeanie	Jeannie	Nettie	Netty	Netta
Jemima	Jem	Jemma	Mima	Mimi
Jennifer	Jen	Jenny	Jennie	Jenne
Jenny	Jane	Jennifer	Virginia	Genevieve
Jessica	Jess	Jessie
Jill	Gillian
Joanna	Joanne	Joann	Johanna	Joan	Jo	Jody
Joceline	Jocelyn	Jo	Lynn
Josephine	Josepha	Jo	Josie	Josey	Jozy	Jody	Pheny
Joyce	Joy
Judith	Judy	Judie	Jude	Jody	Jodie
Julia	Julie	Jule
Julianne	Juliana	Julie	Jule
Juliet	Juliette	Julie	Jule
Justina	Justine	Tina
Karen	Karin	Karyn	Kari	Karrie
Katherine	Katharine	Kathryn	Kathrine	Kathrynne	Katrina	Kate	Kathie	Kathy	Katie	Katy	Kay	Katty	Kattie	Kit	Kitty	Kittie
Kathleen	Kathlene	Kathlyn	Kathlynne	Kathie	Kathy	Katie	Katy	Katty	Kattie
Kelly	Kellie	Kelli	Kelley
Kimberly	Kimberley	Kim
Kristina	Kristin	Kristine	Kristen	Kris	Kristi	Kristy	Kristie	Krista
Laura	Laurie	Lauri	Lolly
Laureen	Laurene	Laurena	Laurine	Lauren	Laurie
Laurel	Laurie
Laverne	Laverna	Verna	Verna
Lavinia	Vina	Vinnie
Leah	Lea	Lee	Leigh
Leila	Leilah	Lela	Lila
Lena	Helen	Aileen	Arlene	Darlene	Magdalene
Leona	Lee	Leonie
Leonora	Leonore	Lenora	Lenore	Nora
Leslie	Lesley	Les
Leticia	Letitia	Lettie	Tisha
Lillian	Lilian	Lily	Lilly	Lili	Lilli	Lil	Lillie
Lily	Lilly	Lili	Lilli	Lil	Lillie
Linda	Lynda	Lindy	Lin	Lynn	Lynne
Lindsay	Lindsey	Lin	Lynn
Lois	Eloise	Louise
Lona	Loni	Lonie	Lonnie
Lora	Lori	Lorie	Lorri	Lorrie
Lorena	Lorene	Loreen	Lorine	Lori	Lorie	Lorri	Lorrie
Loretta	Lorette	Lori	Lorrie	Etta	Retta
Lorinda	Laurinda	Lori	Lorie	Lorrie	Laurie
Lorraine	Lorrain	Loraine	Lora	Lori	Lorie	Lorrie
Lottie	Lotty	Lotta	Charlotte	Carlotta
Louise	Louisa	Lou	Lu	Lulu	Lula	Lois
Lucille	Lucile	Lu	Lucy	Lucky
Lucinda	Lu	Lucy	Lucky	Cindy
Lucy	Lucie	Luci	Lucia	Lu	Lulu	Luce	Lucky	Lucille	Lucinda
Lydia	Liddy	Lyddie
Lynn	Lynne	Caroline	Marilyn	Linda	Arlene	Evelyn
Amabel	Mabel	Mabelle	Mable	Mab	Mabs	Mabbie
Madeleine	Madeline	Madelyn	Maddie	Maddy	Mady
Magdalene	Magdalen	Magdalena	Magdaline	Magda	Magsie	Lena
Marcia	Marcie	Marcy	Marci
Margaret	Margarita	Marguerite	Margret	Maggie	Marge	Margie	Marjorie	Margery	Madge	Margot	Margo	Magsie	Maisie	Daisy	Mamie	Maidie	Mae	May	Meg	Megan	Peggy	Greta	Gretchen	Rita
Marianne	Marianna	Maryann	Maryanne	Marian	Mary	Ann
Marilyn	Marilynn	Marylin	Marlene	Marlyn	Mary	Lynn
Maribel	Maribelle	Mary	Bell
Marietta	Mariett	Mariette	Mary	Etta	Ettie	Etty
Marjorie	Marjory	Margery	Marge	Margie	Margaret
Martha	Marta	Marty	Martie	Mat	Mattie	Matty	Pat	Pattie	Patty
Martina	Martine	Marty	Martie
Mary	Maria	Marie
Mary	Mae	May	Moll	Molly	Mollie	Polly	Mamie	Mimi	Minnie
Matilda	Mathilda	Mat	Mattie	Matty	Maud	Maude	Patty	Pattie	Tilda	Tillie	Tilly
Maud	Maude	Maudie	Maudy	Matilda
Maureen	Maurene	Maura	Mary
Maxine	Max	Maxie
Megan	Meg	Margaret
Melanie	Melany	Mel	Mellie
Melinda	Mel	Mellie	Linda	Mindy
Melissa	Mel	Mellie	Missie	Missy	Lisa	Lissa
Mercedes	Mercy	Sadie
Meredith	Merry
Michelle	Michele	Mickey	Shelly
Mildred	Millie	Milly
Millicent	Milicent	Melicent	Millie	Milly
Minnie	Minna	Mina	Wilhelmina	Mary
Mirabel	Mirabella	Mira	Bella
Miranda	Randy
Miriam	Myriam	Mimi	Miri	Mira
Moira	Moyra
Molly	Mollie	Moll	Polly	Mary
Monica	Nicki
Myra	Mira
Nadine	Nada	Dee
Natalie	Nathalie	Natalia	Natasha	Nattie	Natty
Nancy	Anna
Nell	Nelle	Nellie	Nelly	Eleanor	Helen	Cornelia
Nettie	Netty	Netta	Annette	Antoinette	Henrietta	Janet	Jeannette
Nicki	Dominique	Monica	Nicole	Veronica
Nicole	Nicky	Nicki	Nikki	Nikky
Nina	Anna
Noel	Noelle	Elle
Nora	Norah	Norrie	Norry
Nora	Eleanor	Leonora	Noreen	Honora
Noreen	Norene	Nora
Norma	Normie
Octavia	Tave	Tavy	Tavia
Olive	Olivia	Ollie	Olly	Nollie	Liv	Livvy	Livia
Pamela	Pam	Pammie	Pammy
Patricia	Pat	Patty	Patti	Pattie	Patsy	Tricia	Trisha	Trish	Trissie	Trissy
Paula	Paulina	Pauline	Paulie
Pearl	Pearlie
Peggy	Peg	Margaret
Penelope	Pen	Penny
Phoebe	Phebe	Pheb
Phyllis	Phyl	Phyllie	Phil
Polly	Mary	Molly
Priscilla	Prissy
Prudence	Prudie	Prudy	Prue	Pru
Rachel	Rachie	Rae	Ray	Rache
Raquel	Kelly	Kellie
Rebecca	Rebekah	Becky	Beckie	Becca	Beck	Reba
Regina	Reggie	Ray	Gina	Ginny	Rena
Renata	Nata	Natie	Rennie	Renny	Renae
Renee	Renata
Rhoda	Rodie
Roberta	Robbie	Robby	Robin	Robyn	Bobbie	Bobby	Berta	Bertie
Rose	Rosa	Rosie	Rosy
Rosabel	Rosabelle	Rosabella	Rose	Rosie	Rosy	Bell
Rosalie	Rosalee	Rose	Rosie	Rosy
Rosaline	Rosalyn	Rose	Rosie	Rosy
Rosalind	Rosalinda	Rose	Rosie	Rosy	Linda
Roseanna	Rosanna	Rosanne	Rose	Rosie	Rosy
Rosemary	Rosemarie	Rose	Rosie	Rosy
Rowena	Rona	Ronie
Roxanne	Roxanna	Roxana	Roxie	Roxy
Ruby	Rubina	Ruby	Rubie
Ruth	Ruthie
Sabrina	Brina	Sabby
Samantha	Sam	Sammie	Sammy
Sarah	Sara	Sal	Sally	Sallie	Sadie
Selina	Selena	Selene	Celine	Celina	Celena	Lena	Lina
Selma	Selmie
Shannon	Shanon
Sharon	Sharron	Sharen	Sharyn	Shari	Sharrie
Shauna	Shawna	Sheena
Shelley	Shelly	Shellie
Shirley	Shirlee	Shirlie	Shirl
Sibyl	Sybil	Sibylle	Sybill	Syble	Sib	Sibbie	Sibby
Sidney	Sydney	Sid	Syd
Sonia	Sonya
Sophia	Sophie	Sophy
Stacy	Stacey	Stacie	Staci	Anastasia	Eustacia
Stephanie	Stephany	Stephania	Stephana	Stefanie	Stefania	Stefana	Steffanie	Steph	Stephie	Steff	Steffy	Stevie
Stella	Estelle
Susan	Susanna	Susannah	Susanne	Suzanne	Sue	Susie	Susi	Susy	Suzie	Suzy	Sukie
Sylvia	Silvia	Syl	Sylvie
Tabitha	Tabby
Tamara	Tamar	Tammy	Tammie
Tanya	Tania
Teresa	Theresa	Therese	Terry	Terri	Teri	Terrie	Tess	Tessa	Tessie	Tracy	Trissie	Trissy
Theodora	Dora	Theo
Tiffany	Tiff	Tiffy
Tina	Christine
Tracy	Tracey	Tracie	Traci	Teresa
Ulrica	Ulrika
Ursula	Ursa	Ursie	Sulie
Valentina	Val	Vallie
Valerie	Valery	Valeria	Val	Vallie
Vanessa	Van	Vannie	Vanna	Nessa	Essa
Verna	Laverne
Veronica	Nicky	Nicki	Ronnie	Ronni	Ronny
Victoria	Vic	Vick	Vickie	Vicky	Vicki	Viki	Vikki
Viola	Vi
Violet	Violette	Violetta	Vi	Lettie
Virginia	Ginger	Ginny	Jinny	Jenny	Virgie
Vivian	Vivien	Viv
Wendy	Gwendolen
Wilhelmina	Willa	Wilma	Willie	Billie	Mina	Minnie
Winifred	Winnie	Freda	Freddie
Yolanda	Yolande
Yvonne	Vonnie	Vonna
Yvette	Vettie	Vetta
Zoe	Zoey
Aaron	Aron	Ron	Ronnie	Ronny
Abel	Abe	Abie
Abner	Ab	Abbie
Abraham	Abram	Abe	Abie	Bram
Adam	Ad	Addie	Addy	Ade
Adelbert	Adalbert	Ad	Ade	Al	Bert	Bertie	Del
Adrian	Ade
Alan	Allan	Allen	Al
Albert	Al	Bert	Bertie
Alexander	Al	Alex	Alec	Aleck	Lex	Sandy	Sander
Alfred	Al	Alf	Alfie	Fred	Freddie	Freddy
Algernon	Algie	Algy	Alger
Alister	Allister	Alistair	Alastair	Alaster	Al
Alonso	Alonzo	Al	Lon	Lonnie	Lonny
Alphonso	Alfonso	Al	Alf	Alfie	Alonso	Lon
Alva	Alvah	Alvan	Al
Alvin	Alwin	Alwyn	Al	Vin	Vinny	Win
Ambrose	Ambie	Brose
Andrew	Andy	Drew
Angus	Gus
Anselm	Ansel	Anse
Anthony	Antony	Anton	Tony
Archibald	Arch	Archie	Baldie
Arnold	Arnie
Arthur	Art	Artie
Augustus	August	Augie	Gus	Gussy	Gust	Gustus
Augustine	Augustin	Augie	Austin	Gus	Gussy	Gust
Austin	Augustine
Avery	Avy
Baldwin	Baldie	Win
Barrett	Barry	Barrie
Bartholomew	Bart	Barty	Bartlett	Bartley	Bat	Batty
Basil	Baz	Basie
Benedict	Ben	Bennie	Benny
Benjamin	Ben	Bennie	Benny	Benjy	Benjie
Bennet	Bennett	Ben	Bennie	Benny
Bernard	Barnard	Bernie	Berney	Barney	Barnie
Bert	Bertie	Albert	Adelbert	Bertram	Delbert	Egbert	Elbert	Gilbert	Herbert	Hubert	Lambert	Osbert	Robert	Wilbert
Berthold	Bert	Bertie
Bertram	Bertrand	Bert	Bertie
Bill	Billy	Billie	William	Willis
Bradford	Brad	Ford
Bradley	Brad
Brandon	Branden	Brand	Brandy
Brenton	Brent
Bret	Brett
Brian	Bryan	Bryant
Broderick	Brodie	Brody	Brady	Rick	Ricky
Burton	Burt
Byron	Ron	Ronnie	Ronny
Caleb	Cal
Calvin	Cal	Vin	Vinny
Cameron	Cam	Ron	Ronny
Carey	Cary	Carry
Carl	Karl
Carol	Carrol	Carroll
Casey	Kasey
Caspar	Casper	Cas	Cass
Cassius	Cas	Cass
Cecil	Cis
Cedric	Ced	Rick	Ricky
Charles	Charlie	Charley	Chuck	Chad	Chas
Chester	Chet
Christian	Chris	Christy	Kit
Christopher	Kristopher	Chris	Kris	Cris	Christy	Kit	Kester	Kristof	Toph	Topher
Clarence	Clare	Clair
Clare	Clair
Clark	Clarke
Claude	Claud
Clayton	Clay
Clement	Clem
Clifford	Cliff	Ford
Clinton	Clint
Colin	Collin	Cole
Conrad	Con	Connie	Conny
Corey	Cory
Cornelius	Connie	Conny	Corny	Corney	Cory
Curtis	Curt
Cyril	Cy
Cyrus	Cy
Daniel	Dan	Danny
Darrell	Darrel	Darryl	Daryl	Darry
David	Dave	Davey	Davie	Davy
Dean	Deane
Delbert	Del	Bert	Bertie
Dennis	Denis	Den	Denny
Derek	Derrick	Rick	Ricky
Desmond	Des
Dexter	Dex
Dominic	Dominick	Domenic	Domenick	Dom	Nick	Nicky
Don	Donnie	Donny
Donald	Don	Donnie	Donny
Donovan	Don	Donnie	Donny
Douglas	Douglass	Doug
Drew	Andrew
Duane	Dwayne
Dudley	Dud	Duddy
Duncan	Dunny	Dunk
Dustin	Dusty
Dylan	Dillon
Earl	Earle
Edgar	Ed	Eddie	Eddy	Ned
Edmund	Edmond	Ed	Eddie	Eddy	Ned	Ted
Edward	Ed	Eddie	Eddy	Ned	Ted	Teddy
Edwin	Ed	Eddie	Eddy	Ned
Egbert	Bert	Bertie
Elbert	El	Bert	Bertie
Eldred	El
Elijah	Elias	Eli	Lige
Elliot	Elliott	El
Ellis	El
Elmer	El
Elton	Alton	El	Al
Elvin	Elwin	Elwyn	El	Vin	Vinny	Win
Elvis	El
Elwood	El	Woody
Emery	Emmery	Emory	Em
Emil	Emile	Em
Emmanuel	Emanuel	Immanuel	Manuel	Manny	Mannie
Emmet	Emmett	Em
Eric	Erik	Erick	Rick	Ricky
Ernest	Earnest	Ernie
Ervin	Erwin	Irvin	Irvine	Irving	Irwin	Erv	Vin	Win
Eugene	Gene
Eustace	Stacy	Stacey
Evan	Ev
Everard	Ev
Everett	Ev
Fabian	Fabe	Fab
Felix	Lix
Ferdinand	Ferdie	Fred	Freddie
Fergus	Ferguson	Fergie
Floyd	Floy	Lloyd
Ford	Bradford	Clifford	Sanford
Francis	Frank	Frankie	Franky	Fran
Franklin	Franklyn	Frank	Frankie	Franky
Frederick	Frederic	Fredrick	Fredric	Fred	Freddie	Freddy	Rick	Ricky
Fred	Freddie	Alfred	Frederick	Wilfred	Winfred
Gabriel	Gabe	Gabby
Garrett	Garret	Gary	Garry
Geoffrey	Jeffrey	Jeffery	Jeff
George	Georgie	Geordie
Gerald	Gerard	Gerry	Jerry
Gilbert	Gil	Bert
Glenn	Glen
Gordon	Gordy	Don
Gregory	Gregor	Greg	Gregg
Griffith	Griffin	Griff
Harold	Hal	Harry
Harris	Harrison	Harry
Harvey	Harve
Henry	Harry	Hank	Hal
Herbert	Herb	Bert	Bertie
Herman	Manny	Mannie
Hilary	Hillary	Hill	Hillie	Hilly
Horace	Horatio
Howard	Howie
Hubert	Hugh	Bert	Bertie	Hube
Hugh	Hughie	Hugo
Humphrey	Humphry	Humph
Ignatius	Iggy	Nate
Immanuel	Manny	Mannie	Emmanuel
Irvin	Irvine	Irving	Irwin	Ervin
Isaac	Isaak	Ike
Isidore	Isidor	Isadore	Isador	Izzy
Jack	Jackie	Jacky	John
Jacob	Jake	Jay
James	Jim	Jimmy	Jimmie	Jamie	Jem
Jared	Jerry
Jarvis	Jervis	Jerry
Jason	Jay
Jasper	Jay
Jefferson	Jeff
Jeffrey	Jeffery	Geoffrey	Jeff
Jeremy	Jeremiah	Jerry
Jerome	Jerry
Jesse	Jess	Jessie	Jessy
Joel	Joe
John	Jack	Jackie	Jacky	Johnny
Jonathan	Jon	Jonny
Joseph	Joe	Joey	Jo	Jos	Jody
Joshua	Josh
Judson	Jud	Sonny
Julian	Julius	Jule	Jules
Justin	Jus	Just
Karl	Carl
Kelly	Kelley
Kelvin	Kel	Kelly
Kendall	Ken	Kenny
Kendrick	Ken	Kenny	Rick	Ricky
Kenneth	Ken	Kenny
Kent	Ken	Kenny
Kevin	Kev
Kristopher	Kristofer	Kris	Kit	Kester	Christopher
Kurt	Curt
Lambert	Bert
Lamont	Monty	Monte
Lancelot	Launcelot	Lance
Laurence	Lawrence	Lorence	Lorenzo	Larry	Lars	Laurie	Lawrie	Loren	Lauren
Lee	Leigh
Leo	Leon	Lee
Leonard	Leo	Leon	Len	Lenny	Lennie
Leopold	Leo	Poldie
Leroy	Leeroy	Lee	Roy
Leslie	Lesley	Les
Lester	Les
Lewis	Lew	Lewie
Lincoln	Lin	Linc	Lynn
Lindon	Lyndon	Lin	Lynn
Lindsay	Lindsey	Lin	Lynn
Lionel	Leo	Leon
Llewellyn	Llew	Lyn
Lloyd	Loyd	Loyde	Floyd	Loy	Floy
Lonnie	Lonny	Alonso
Louis	Lou	Louie
Lowell	Lovell
Lucian	Lucius	Lu	Luke
Luke	Lucas	Luke
Luther	Loot	Luth
Lyle	Lyall
Malcolm	Mal	Malc	Mac
Manuel	Manny	Mannie	Emmanuel
Mark	Marc	Marcus	Mark	Marc
Marshall	Marshal
Martin	Mart	Marty
Marvin	Mervin	Marv	Merv
Matthew	Matt	Mat	Matty	Mattie
Matthias	Matt	Mat	Matty	Mattie
Maurice	Morris	Morry	Morey	Moe
Maximilian	Max
Maxwell	Max
Melvin	Mel
Merlin	Merle
Merrill	Merril	Merill
Michael	Mike	Mikey	Mick	Mickey	Micky
Miles	Myles	Milo
Milton	Milt
Mitchell	Mitch
Monroe	Munroe
Montague	Monty	Monte
Montgomery	Monty	Monte
Morgan	Mo
Mortimer	Mort	Morty
Morton	Mort	Morty
Moses	Mo	Moe	Mose	Moss
Murray	Murry
Nathan	Nathaniel	Nat	Nate	Natty
Neal	Neil
Nelson	Nel	Nell	Nels
Nevill	Nevil	Nevile	Neville	Nev
Newton	Newt
Nicholas	Nicolas	Nick	Nicky	Nicol	Cole	Colin
Nigel	Nige
Noel	Nowell
Norbert	Bert
Norris	Nor	Norrie
Norman	Norm	Normie	Nor	Norrie
Norton	Nort
Oliver	Ollie	Noll	Nollie	Nolly
Orville	Orv	Ollie
Osbert	Ossy	Ozzie	Ozzy	Bert
Osborn	Osborne	Ossy	Ozzie	Ozzy
Oscar	Os	Ossy
Osmond	Osmund	Ossy	Ozzie	Ozzy
Oswald	Oswold	Os	Ossy	Oz	Ozzie	Ozzy
Patrick	Pat	Paddy	Patsy
Paul	Pauly
Percival	Perceval	Percy	Perce
Peter	Pete	Petie	Petey
Philip	Phillip	Phil	Pip
Quentin	Quintin	Quenton	Quinton	Quinn
Quincy	Quincey	Quinn
Ralph	Raff	Rafe	Ralphy
Randall	Randal	Rand	Randy
Randolph	Rand	Randy	Dolph
Raphael	Rafael	Raff	Rafe
Raymond	Raymund	Ray
Reginald	Reg	Reggie	Renny	Rex
Reuben	Ruben	Rubin	Rube	Ruby
Reynold	Ray
Richard	Dick	Rick	Ricky	Rich	Richie
Rick	Ricky	Cedric	Derek	Eric	Frederick	Richard	Roderic	Broderick	Kendrick
Robert	Bob	Bobbie	Bobby	Dob	Rob	Robbie	Robby	Robin	Bert
Roderic	Roderick	Rod	Roddy	Rick	Ricky
Rodney	Rod	Roddy
Roger	Rodger	Rod	Roddy	Rodge	Roge
Roland	Rowland	Rolly	Roly	Rowly	Orlando
Rolph	Rolf	Rolfe	Rudolph
Roman	Rom	Romy
Ronald	Ron	Ronnie	Ronny
Ron	Ronnie	Ronny	Aaron	Byron	Cameron	Ronald
Roscoe	Ross
Rudolph	Rudolf	Rudy	Rolf	Rolph	Dolph	Dolf
Rufus	Rufe
Russell	Russel	Russ
Samson	Sampson	Sam	Sammy
Samuel	Sam	Sammy
Sanford	Sandy	Ford
Scott	Scotty
Sean	Shaun	Shawn	Shane
Sebastian	Seb	Bass
Seymour	Morey	Sy
Shannon	Shanon
Sheldon	Shelly	Shel	Don
Shelley	Shelly	Shellie	Shel
Shelton	Shelly	Shel	Tony
Sidney	Sydney	Sid	Syd
Silas	Si	Sy
Silvester	Sylvester	Syl	Vester
Simeon	Sim	Simie	Simmy
Simon	Si	Sy	Sim	Simie	Simmy
Solomon	Sol	Solly	Sal
Sonny	Son
Stacy	Stacey	Eustace
Stanley	Stan
Stephen	Steven	Stephan	Steffan	Stefan	Steve	Stevie	Steph	Steff	Stef
Stuart	Stewart	Stu	Stew
Terence	Terrence	Terrance	Terry
Thaddeus	Thadeus	Tad	Thad
Theodore	Theodor	Ted	Teddy	Theo	Terry
Thomas	Tom	Tommy
Timothy	Tim	Timmy
Tobias	Toby	Tobi	Tobie
Tony	Anthony
Tracy	Tracey
Travis	Trav
Trenton	Trent
Trevor	Trev
Tristram	Tristam	Tristan	Tris
Tyler	Ty
Tyrone	Tyron	Ty
Ulysses	Uly	Uli	Lyss
Uriah	Urias	Uri	Uria
Valentine	Valentin	Val
Valerian	Valerius	Val
Vance	Van
Vaughan	Vaughn
Vernon	Vern	Verne
Victor	Vic	Vick
Vincent	Vince	Vin	Vinny
Virgil	Vergil	Virge
Wallace	Wallis	Wally	Wallie
Walter	Walt	Wally	Wallie
Wesley	Wes
Wendell	Dell	Del
Wilbert	Will	Willie	Willy	Bert
Wilbur	Wilber	Will	Willie	Willy
Wiley	Will	Willie	Willy
Wilfred	Wilfrid	Will	Willie	Willy	Fred	Freddie	Freddy
Willard	Will	Willie	Willy
William	Bill	Billy	Billie	Will	Willie	Willy	Liam
Willis	Bill	Billy	Billie	Will	Willie	Willy
Wilson	Will	Willie	Willy
Winfred	Winfrid	Win	Winnie	Winny	Fred	Freddie	Freddy
Winston	Win	Winnie	Winny
Woodrow	Wood	Woody
Xavier	Zave
Zachary	Zachariah	Zacharias	Zack	Zacky	Zach
Babe Ruth	The Great Bambino
Eddard	Ned
Huckleberry	Huck	Hucky